8
9
HPPPLPPPP
PPPPHPPPP
PPLHPFPPH
PPPFPPPHP
PPPLPPPPP
PFPPHFPHP
HPPHPFHPP
PPHPFHPPP
flytrap west 4 5 
