12
13
PLFPPHFPHPPPL
LPHPLPPPPPPLP
PPPFPPPPFLHPP
LPFPPPFPHPPPH
PPPPPHPLFPPPP
HHPPPPFFPLPPH
HPPHPPHLLPLHP
PPPPHPPPPPPPP
LHPLLHPHLFPLP
PPPPPPPPPPPPL
HHPHPPLPHPPPP
LLHPPPPPPPPLL
rrover east 4 0 
food west 0 11 a 
rrover east 4 1 f 
