12
9
FHPHLLPPL
LPFFPFLPL
FFFPLLLFL
HHPHPFPHH
PLPLPPLLL
PPFHPPPFL
FHFFHHHHL
FFLFLFHFL
HHPFPFPPP
FFLFLFFFP
LPFLPLPFP
FPLHLFLPP
rrover west 10 4 a f
hop east 5 0
landmine west 11 8
food north 11 4 f
