13
17
PHPPHPPPPHHPPPPPP
PPHLLHPFLPPFPFPPL
FPLLHPLHFHPFHPPPP
PPHPHLPPPHHFPFPFP
PFLHPPLFPLLPPLPPL
PPPHFHLPFPPPLFPPP
PHPHPPFPPHPHPLPFP
PPPPLHPPHHFPPPPPP
PFPLHHFHHPLPFPFPP
FLPLLPFPPHFPPHPFP
PPPHPPHPPFPPFFFPL
PPHPLPPPPPPLHPPPL
HHLHPPPPPPPHPHPLL
rrover east 3 6 
hop east 1 13 
food east 5 3 
