13
18
PPPPPPPPPHPFPLPLPL
PLPPLPHPPPPPPLPPPP
HPPPPHLPLLPLPPPLPP
LPPPPHFHFFPLLPPPPP
PPPHHPFPFPPPPPPLPF
LFPPPHPPPPPPPPPFPP
HPLPPPPLPLFPPPLHLP
LPPHPPPFPHPFPPLPLP
PPPPPFPPPHPLHPHPPP
FFLLPPPLPPLPPHPPHP
PPPPHPHHLLPPHFFLPP
LHHPPLPFFPPPLPFLPP
PPPPLPPLPHPFPPPPPL
flytrap east 3 8 
hop east 0 3 f 
rrover north 7 1 f 
rrover north 6 13 f 
landmine west 9 0 a f 
